....................................................................................................................................................................................................................................................................................................................................................................................................................................................................................................................
....................................................................................................................................................................................................................................................................................................................................................................................................................................................................................................................
....................................................................................................................................................................................................................................................................................................................................................................................................................................................................................................................
..................................................................................................................................................................................................................................................................................................................................................................................................................................................................................B.................................
....................................................................................................................................................................................................................................................................................................................................................................................................................................................................................................................
..................................................................................................................................................................................................................................................................................................................................................................................#................................................................................................................................#
..................................................................................................................................................................................................................................................................................................................................................................................#................................................................................................................................#
..................................................................................................................................................................................................................................................................................................................................................................................#................................................................................................................................#
..................................................................................................................................................................................................................................................................................................................................................................................#...............................................................................................................................##
..................................................................................................................................................................................................................................................................................................................................................................................#................................................P..............................................................................##
......................................................#########...................................................................................................................................................................................................................................................................................................................#...............................................................................................................................##
.......................................................#######..................##############....................................................................................................................................................................................................................................................................................#..............................................................................................................................###
............................#############................##..........................#######......................................................................................................................................................................................................................................................................................#..............................................................................................................................###
...............................#######............................................................................................................................................................................................................................................................................................................................................#..............................................................................................................................###
.......................................................................G..........................................................................................................................................................................................................................................................................................................#..............................................................................................................................###
..................................................................................................................................................................................####################............................................................................................................................................................................#..............................................................................................................................###
..................................................................................................................................................................................................................................................................................................................................................................................#..............................................................................................................................###
................................................................................................................................................................##########.........................#..............................................................................................................................................................................#..............................................................................................................................###
........................................................................................................................................................................................................#.........######..........................................................................................................................................................#..............................................................................................................................###
........................................................................................................................................................................................................#.........................................................................................................................................................................#..............................................................................................................................###
...............######...................................................................................................................................................................................#.........................................................................................................................................................................#..............................................................................................................................###
##########################################################################################...............................#############################...............................##############################################################################...............................##################################################..............................##################################################################################################################################
####################################################################################################################################################################################################################################################################################################################################################################################################################################################################################################################
####################################################################################################################################################################################################################################################################################################################################################################################################################################################################################################################
####################################################################################################################################################################################################################################################################################################################################################################################################################################################################################################################